********************************************************************************
*______________________________________________________________________________*
*______________________________________________________________________________*
*______________________________________________________________________________*
*______________________________________________________________________________*
*______________________________________________________________________________*
*______________________________________________________________________________*
*______________________________________________________________________________*
*______________________________________________________________________________*
*______________________________________________________________________________*
*______________________________________________________________________________*
*______________________________________________________________________________*
*______________________________________________________________________________*
*____________________________******************________________________________*
*_______________________________________****************_______________________*
*____________________________________________*******************_______________*
*________________________________________________________************__________*
*______________________________________________________________________________*
*______________________________________________________________________________*
*______________________________________________________________________________*
*______________________________________________________________________________*
*______________________________________________________________________________*
*______________________________________________________________________________*
*____________________**************____________________________________________*
*_____________***************__________________________________________________*
*_____________************_____________________________________________________*
*________________*********_____________________________________________________*
*___________________******_____________________________________________________*
*___________________******_____________________________________________________*
*_______________**********_____________________________________________________*
*_________****************_____________________________________________________*
*_______***************________________________________________________________*
*_____________*************____________________________________________________*
*______________________________________________________________________________*
*______________________________________________________________________________*
*______________________________________________________________________________*
*______________________________________________________________________________*
*______________________________________________________________________________*
*______________________________________________________________________________*
*______________________________________________________________________________*
*______________________________________________________________________________*
*______________________________________________________________________________*
*______________________________________________________________________________*
*______________________________________________________________________________*
*______________________________________________________________________________*
*______________________________________________________________________________*
*______________________________________________________________________________*
*______________________________________________________________________________*
*______________________________________________________________________________*
*______________________________________________________________________________*
*______________________________________________________________________________*
*____________________________*************_____________________________________*
*______________________________________________________________________________*
*______________________________________________________________________________*
*______________________________________________________________________________*
*______________________________________________________________________________*
*______________________________________________________________________________*
*______________________________________________________________________________*
********************************************************************************
